
Jet Li: Hős
Natalie Portman: V mint vérbosszú
Irene Jacob: Veronica kettős élete
Jan Vostrcil: Tűz van, babám!
Brenton Thwaites: Az emlékek őre
Irene Jacob: Három szín: Piros
Bajram Severdzan: Macska-jaj
Heath Ledger: Doktor Parnassus és a képzelet birodalma
Martin Freeman: Galaxis útikalauz stopposoknak
Catinca Untaru: Zuhanás
Nenad Janković: Cigányok ideje
Anthony Higgins: A rajzoló szerződése
Treat Williams: Hair
Toshirô Mifune: A vihar kapujában
John Travolta: Ponyvaregény
Leonardi DiCaprio: Eredet
Roberto Benigni: Az élet szép
Robert de Niro: Brazil
Henry Fonda: Tizenkét dühös ember
Graham Chapman: Gyalog galopp
Edward Norton: Harcosok klubja
Graham Chapman: Brian élete
Brad Pitt: 12 majom
Takeshi Kaneshiro: A repülő tőrök klánja
Slavko Štimac: Az élet egy csoda
Jack Nicholson: Száll a kakukk fészkére
Brad Pitt: Blöff
Hyun-kyoon Lee: Lopakodó lelkek
Oh Yeong-su: Tavasz, Nyár, Ősz, Tél... és Tavasz
Bruno Ganz: Berlin felett az ég
Diane Keaton: Annie Hall
Franka Potente: A lé meg a Lola
Toshirô Mifune: A hét szamuráj
Sir John Gielgud: Prospero könyvei
Yoshiko Kuga: A félkegyelmű
Ben Whishaw: Parfüm: Egy gyilkos története
Johnny Depp: Félelem és reszketés Las Vegasban